RGB= 123
S = grv
s



        11111111111111111111111111
        100000000011000000000000001
        10110000011100000000000011
        1001000000000000000N00001
111111111011000001110000000000001
111111111111111111111111111111111
