   





NO content/colorstone.xpm	
	 		  
SO content/redbrick.xpm
WE content/bluestone.xpm
EA content/purplestone.xpm

C 0,0,255
F 69,69,69

         1111111111111111111111111
        100000000011000000000000001
        1001100100111001000001010011
        10010011000000100000100W0011
111111111011100101110000000111010011
1111111110111111111100000000000001
         111111111111111111111111