   

NO content/colorstone.xpm
SO content/redbrick.xpm
WE content/bluestone.xpm
EA content/purplestone.xpm

C 0,0,45
F 69,69,111
            1111111
         111110001111
         1100000000111
        111000011111111111
       11100111        111
 1111111000111      1    111
 11000011000111          111
 110000110000111        1111
 110000110000011111111111111
 11000011000000000000000000111111111
 11000001000000000000000000000000001
 110000000000000W0000000000111111111
 110000110000000000000000001
 110001110000000000000000001
  1111111000001111111110111
        1100000111 111100111
        1100000011  11000111
        1100000001   1000001
        1111111111   1111111
