NO content/bedrock.xpm
SO content/grass.xpm
WE content/portal.xpm
EA content/portaloff.xpm

C 225,30,0
F 1,100,0

 111111111
1011111N0111111011111111
1111111011111110000000001
111110111111111111111111
1 111011111
 1111111