   
NO content/bedrock.xpm
SO content/grass.xpm
WE content/portal.xpm
EA content/portaloff.xpm

C 255,255,255
F 69,69,69

         1111111111111111111111111
        1000000000110000000000E0001
        100110010011100100000100001
        100100110000001000001000001
11111111101110010111000000011100001
1111111110111111111100000000000001
         111111111111111111111111