   
NO content/bedrock.xpm
SO content/grass.xpm
WE content/portal.xpm
EA content/portaloff.xpm

C 0,225,225
F 69,69,69

        11111111111111111111111111
        100000000011000000000000001
        10110000011100E000000000011
        10010000000000000000000001
111111111011000001110000000000001
111111111111111111110000000000001
111111111111111111111111111111111